811111111111111111111111111113
804004004004004004004004004002
82f82f82f82f82f82f82f82f82f802
801001001001001001001001001002
804004004004040444004004004002
82f82f82f82fefafff82f82f82f802
80100100102fff857f801001001002
8040040040013fafff804004004002
82f82f82f8002fafff82f82f82f802
801001001040010111001001001002
8040040002f8040040040040040002
82f82f8040102f82f82f82f82f8002
80100102f800010010010010010002
800000001000000000000000000002
c44444444444444444444444444442

0,0
19,14
EEEEEEEEEEEEEEEEEESSSSSSSSSSSSESS
