+-+-+-+-+-+-+-+-+-+-+-+-+-+-+-+-+-+-+-+-+
| |         |         |         |       |
+ +-+-+ +-+ +-+-+-+ +-+ + +-+-+-+ +-+-+ +
|   |   | |       | |   |           |   |
+-+ + +-+ +-+-+-+ + + +-+-+-+-+-+-+-+ +-+
| |   |       |   |         |       |   |
+ +-+-+ +-+ +-+ +-+-+-+-+-+ + +-+-+ +-+ +
|   |   |   |   |       |   |   |   |   |
+ + + +-+ + + +-+-+ +-+ +-+-+-+ + +-+ +-+
| | | |   | | |     |   |       | |     |
+ +-+ + +-+-+ + +-+-+ +-+ +-+-+-+ +-+-+ +
|     |       |     |     |           | |
+ +-+-+-+-+-+-+ +-+ + +-+-+-+-+-+-+-+ + +
| |           |   | | |           |   | |
+ +-+-+ + +-+ +-+-+ +-+ +-+-+-+-+ +-+ + +
| |   | | |       |   |   |     |   |   |
+ + + +-+ +-+-+-+ + + +-+ +-+ + +-+ +-+-+
|   | |   |   | | | |   |   | |   |     |
+-+-+ + +-+ + + + + +-+ +-+ +-+ +-+-+ + +
|   | |     | |   |   |   |     |   | | |
+ +-+ + +-+-+ + +-+-+-+ +-+-+-+ + + +-+ +
| |   |     | | |     |       | | |     |
+ + +-+-+ +-+ + +-+ + +-+-+ + + + +-+-+ +
|   |   | |   |     |   |   | | |   |   |
+ +-+ +-+ + +-+-+-+-+-+ + +-+-+ +-+ +-+-+
| | |     |       |   | |         |     |
+ + + +-+-+-+-+-+ + +-+ +-+-+-+-+ +-+-+ +
| |       |       |   | |     |     |   |
+ +-+-+-+-+ +-+-+-+ + + + +-+ +-+-+-+ + +
|           |       |     |           | |
+-+-+-+-+-+-+-+-+-+-+-+-+-+-+-+-+-+-+-+-+